cell_barcode	Cluster
AACAAAGAGGTATCTC-1	Muscle
AACGAAATCATCGCTC-1	Stem A
AAGATAGCACCTTCCA-1	Stem B
AAGGAATAGAGGGTCT-1	Muscle
AAGTACCCAACTTGGT-1	Stem A
AAGTACCTCTGTTCAT-1	Stem B
AAGTGAATCTGGCCTT-1	Muscle
AATGGAATCACCACAA-1	Stem A
AATTCCTAGCTCTGTA-1	Stem B
AATTTCCCAGTGACCC-1	Muscle
ACAAGCTTCTGCAGCG-1	Stem A
ACCCAAAAGCGACTGA-1	Stem B
ACCCTCAGTGGCTTGC-1	Muscle
ACGATGTAGAGAATCT-1	Stem A
ACGATGTGTCAATCTG-1	Stem B
ACGTAACCACGATTCA-1	Muscle
ACTCCCACAGAACTAA-1	Stem A
ACTGATGAGCCGCACT-1	Stem B
ACTTTGTGTTGCATAC-1	Muscle
AGACCCGAGGCTCTCG-1	Stem A
AGAGAATGTAACATCC-1	Stem B
AGCCAATGTTCGATTG-1	Muscle
AGCGTATGTCACTAGT-1	Stem A
AGCTTCCGTGAAGCTG-1	Stem B
AGGAGGTTCACTGCTC-1	Muscle
AGGATCTGTCGCTTGG-1	Stem A
AGGATCTTCCACAGGC-1	Stem B
AGGTGTTTCGCGTAGC-1	Muscle
AGTGTTGGTTCTCGCT-1	Stem A
ATGACCACACACGCCA-1	Stem B
ATGAGGGCAAGTCCAT-1	Muscle
ATGAGGGGTAGCCAGA-1	Stem A
ATGCATGGTTCGTTCC-1	Stem B
ATGCCTCTCCAGTGCG-1	Muscle
ATGCGATCAAGAGAGA-1	Stem A
ATTCATCCACAGAAGC-1	Stem B
ATTCCATGTAGCGTCC-1	Muscle
ATTCTACAGTTGGACG-1	Stem A
ATTCTACTCGGCTTGG-1	Stem B
CAATACGTCCCGAACG-1	Muscle
CACTGAATCTAGGCAT-1	Stem A
CACTGGGCATAATGCC-1	Stem B
CAGCAATGTCCTGTCT-1	Muscle
CATACCCTCTCATACC-1	Stem A
CATGCAACAATTGCTG-1	Stem B
CATTGTTTCATTCGGA-1	Muscle
CCACGAGCAGACTGCC-1	Stem A
CCACTTGCATCTTAGG-1	Stem B
CCGGGTAAGAGCGACT-1	Muscle
CCTCACACACGCCACA-1	Stem A
CGATGGCTCTGTGCTC-1	Stem B
CGCAGGTGTTCAGCTA-1	Muscle
CGCATAACATTCAGCA-1	Stem A
CGCATGGGTGTCTAAC-1	Stem B
CGGAATTGTCGTATGT-1	Muscle
CGTGTCTCAAGACTGG-1	Stem A
CTAAGTGGTCATATGC-1	Stem B
CTACGGGTCACTTATC-1	Muscle
CTATCTAAGCACTGGA-1	Stem A
CTATCTATCCAACCGG-1	Stem B
CTCAACCCATGTCTAG-1	Muscle
CTCTCGAAGCACGATG-1	Stem A
CTCTCGAGTGGAGGTT-1	Stem B
CTGAGCGAGTGTACAA-1	Muscle
CTGAGGCTCTCATGGA-1	Stem A
CTGCAGGCAGGACTTT-1	Stem B
CTGCCATCAGTCTACA-1	Muscle
CTTCGGTGTGCGAACA-1	Stem A
GAAACCTAGCAAGGAA-1	Stem B
GAAACCTGTCCGGATC-1	Muscle
GACATCACAGACCTAT-1	Stem A
GACGTTAAGGTGATAT-1	Stem B
GACTGATCACAAATGA-1	Muscle
GAGCTGCCAAGACCGA-1	Stem A
GCAGGCTTCCTCAGGG-1	Stem B
GCCATGGCACAAAGCG-1	Muscle
GCCATGGTCGCCGAGT-1	Stem A
GCCCAGAGTTGGGCCT-1	Stem B
GCGTGCATCCCAGCGA-1	Muscle
GCTACAACACCTGCAG-1	Stem A
GCTGCAGCACTAGGTT-1	Stem B
GCTGGGTTCCATCAGA-1	Muscle
GGAAGTGCATGTACGT-1	Stem A
GGAGATGCAGCTGAGA-1	Stem B
GGAGGTAGTTGGAGGT-1	Muscle
GGGAGATAGATACATG-1	Stem A
GGGCCATCAAATGGAT-1	Stem B
GGGTCACTCAGTCCGG-1	Muscle
GGGTTATCACTGTCCT-1	Stem A
GGTCTGGAGTCCCAAT-1	Stem B
GGTTAACTCATAGGCT-1	Muscle
GTACAGTAGTGGTCAG-1	Stem A
GTAGTACTCATTCGGA-1	Stem B
GTCCCATAGATTGTGA-1	Muscle
GTCCTCATCGTGGGAA-1	Stem A
GTGTTAGTCTCAACCC-1	Stem B
GTTGCGGCAGTAACGG-1	Muscle
GTTTGGACAAATGCTC-1	Stem A
TACCGAAAGTCTGTAC-1	Stem B
TACCTCGGTTCTTGTT-1	Muscle
TACCTCGTCTCGCGTT-1	Stem A
TACTTACGTCGAATGG-1	Stem B
TAGACCATCGAACACT-1	Muscle
TAGTGCACATCAGCGC-1	Stem A
TATCTGTAGCTAGCCC-1	Stem B
TATGTTCTCATTTGGG-1	Muscle
TATTTCGTCTGTCAGA-1	Stem A
TCAAGCATCTATCCAT-1	Stem B
TCACATTCATGCCGGT-1	Muscle
TCACTCGAGCTCTATG-1	Stem A
TCATTACGTGCTTCAA-1	Stem B
TCCATGCGTACTGGGA-1	Muscle
TCCTCCCAGGTAGTCG-1	Stem A
TCCTCCCGTAGCGTTT-1	Stem B
TCGGGACCATTCACAG-1	Muscle
TCGGGACGTGATATAG-1	Stem A
TCGGTCTCAGATTTCG-1	Stem B
TCTACATCACCTCTGT-1	Muscle
TCTCACGCAAGTTGGG-1	Stem A
TCTTCCTTCGTTCGCT-1	Stem B
TGAGGAGAGGACAGTC-1	Muscle
TGAGGGAAGAGGTTTA-1	Stem A
TGATTTCAGATTGGGC-1	Stem B
TGCGGCACACAAGTGG-1	Muscle
TGCTTCGGTTCTGAGT-1	Stem A
TGCTTCGTCGACTCCT-1	Stem B
TGGGCGTAGTCCCAAT-1	Muscle
TGTCCACCACGCGCAT-1	Stem A
TGTTGAGGTAGTGCGA-1	Stem B
TTAGGCACATCAGCGC-1	Muscle
TTAGGCATCTGGGCAC-1	Stem A
TTCAGGACAATGAACA-1	Stem B
TTCGATTAGTGTAGAT-1	Muscle
TTCTAGTGTATTAAGG-1	Stem A
TTTACCAGTTTAGTCG-1	Stem B
TTTACTGCAGAAGCTG-1	Muscle
TTTCAGTCATCTGTTT-1	Stem A
TTTCGATAGCACTAGG-1	Stem B
TTTGGAGTCCATCACC-1	Muscle
